############
#  o  o    # 
# @  ## @  #
##  @ @   ## 
#    A   o #  
#  #   o   #	
############