############
#  o  o    #
# @     @  #
###  @   ### 
#   A   o  #  
############ 
