################
#x    ##########
#         ######
#              #
######         #
#           a  #
#########      #
################